







NO textures/test/north.xpm








SO textures/test/south.xpm
                        WE textures/test/west.xpm

        F 20,           20,             20
C 200,          200,     200
        EA textures/test/east.xpm            

11111    
10001
100S1                
10001
10001
10001
10001               
10001
10001
10001
10001
10001
11111             

        
